4
1 1 1 1 1 1 1 1
1 1 1 4 4 1 1 1
1 1 6 1 4 4 4 1
1 5 1 1 1 7 1 1
1 4 1 0 0 1 1 1
1 1 1 0 0 8 1 1
4 1 4 0 0 1 2 1
1 1 1 0 0 1 1 1